1 13 31
###############################
#     **s*  1 * 2 *  *s* *    #
# # # #*# # #*#*# # # #*#*#*# #
#  x*     *f*  *  1   * 2 * * #
# # # # # #*# # #*#*# # # # #*#
#f  ***    x **  *  *   1     #
# # # # # # # # # #*# #*# # # #
#*  *f**   s  *      *        #
# # # # #*# # # #*#*# # # # # #
#*    **  *       p           #
# #*# # # # # # #*# # # # # # #
#           *   *  *          #
###############################