1 13 31
###############################
#        f***s                #
# # # # # #*# # # # # # # # # #
#    **f   *    2             #
#*#f# # # #*# # # # # # # # # #
#   1    s**          1       #
# # # # # # # # # # # # # # # #
#   1  *         ***          #
# # # #*# # #*# # # # # # # # #
#  **  *  2  *                #
# # # # # # # # # # # # # # # #
#    f*               2       #
###############################